SSTRTTSSSTRTTSSSTRTTS
SSTRTTSSSTRTTSSSTRTTS
TTTRTTTTTTRTTTTTTRTTT
TTSRSTTTTSRSTTTTSRSTT
TTSRSTTTTSCSTTTTSRSTT
STSSSTSSTSSSTSSTSSSTS
STTTTTSSTTTTTSSTTTTTS
SSTRTTSSSTRTTSSSTRTTS
SSTRTTSSSTRTTSSSTRTTS
TTTRTTTTTTRTTTTTTRTTT
TTSRSTTTTSRSTTTTSRSTT
TTSRSTTTTSCSTTTTSRSTT
STSSSTSSTSSSTSSTSSSTS
STTTTTSSTTTTTSSTTTTTS
SSTRTTSSSTRTTSSSTRTTS
SSTRTTSSSTRTTSSSTRTTS
TTTRTTTTTTRTTTTTTRTTT
TTSRSTTTTSRSTTTTSRSTT
TTSRSTTTTSCSTTTTSRSTT
STSSSTSSTSSSTSSTSSSTS
STTTTTSSTTTTTSSTTTTTS