SSTRTTSSSTTTTSSSTRTTS
SSTRTTSSSTTTTSSSTRTTS
TTTRTTTTTTRTTTTTTRTTT
TTSRSTTTTSRSTTTTSRSTT
TTSRSTTTTTCTTTTTSRSTT
STSSSTSSTSRSTSSTSSSTS
STTTTTSSRRRRRSSTTTTTS
SSTRTTSSSTRTTSSSTRTTS
SSTRTTSSSTRTTSSSTRTTS
TTTRTTTTTTRTTTTTTRTTT
TTSRSTTTTSRSTTTTSRSTT
TTSRSTTTTSCSTTTTSRSTT
STSSSTSSTSSSTSSTSSSTS
STTTTTSSTTTTTSSTTTTTS
SSTRTTSSSTRTTSSSTRTTS
SSTRTTSSSTRTTSSSTRTTS
TTTRTTTTTTRTTTTTTRTTT
TTSRSTTTTSRSTTTTSRSTT
TTSRSTTTTSCSTTTTSRSTT
STSSSTSSTSSSTSSTSSSTS
STTTTTSSTTTTTSSTTTTTS